%%% -------------------------------------------------------------------
%%% Author  : MacX
%%% Description :
%%%
%%% Created : 2011-3-28
%%% -------------------------------------------------------------------
-module (top_bar_manager_sup).

-behaviour(supervisor).
%% --------------------------------------------------------------------
%% Include files
%% --------------------------------------------------------------------

%% --------------------------------------------------------------------
%% External exports
%% --------------------------------------------------------------------
-export([start_link/0]).

%% --------------------------------------------------------------------
%% Internal exports
%% --------------------------------------------------------------------
-export([init/1]).

%% --------------------------------------------------------------------
%% Macros
%% --------------------------------------------------------------------
-define(SERVER, ?MODULE).

%% --------------------------------------------------------------------
%% Records
%% --------------------------------------------------------------------

%% ====================================================================
%% External functions
%% ====================================================================
start_link()->
	supervisor:start_link({local,?MODULE},?MODULE,[]).


%% ====================================================================
%% Server functions
%% ====================================================================
%% --------------------------------------------------------------------
%% Func: init/1
%% Returns: {ok,  {SupFlags,  [ChildSpec]}} |
%%          ignore                          |
%%          {error, Reason}
%% --------------------------------------------------------------------
init([]) ->
    AChild = {top_bar_manager,{top_bar_manager,start_link,[]},
	      permanent,2000,worker,[top_bar_manager]},
    {ok,{{one_for_one,10,10}, [AChild]}}.

%% ====================================================================
%% Internal functions
%% ====================================================================

